11111111111111111111111
1C000000000P000000000E1
10001000100001100000001
10001000100010010000001
10001111100000100000001
10000000100001000000001
10000000100011110000001
11111111111111111111111
