1111111111111
1P00000C000E1
1010111011101
1C0C000C000C1
1010111010101
1C0C0101010C1
1010101011101
1C0C000C000C1
1010111010101
1C00000C000C1
1111111111111
