111111111111111111111
1P00000000000100000E1
101111111101010111101
100000000101010000001
111110101101011111101
1C00001000000000000C1
101011111110111110101
101000000010000010101
101011111011111010101
100000001000000000001
111111111111111111111
